00000000000000000000000000000000000000000
01111011111111101111011111111101111111110
01111011110111101111011110111101111011110
01111111110111101111111110111101111011110
00000000000111101111011110111101111011110
01111111111111101111011110111100000011110
01111011110000001111011110111101111111110
01111011110111111111000000111101111111110
01111000000111101111011111111101111011110
01111111111111101111011110111111111011110
00000000000000000000000000000000000000000
